---#--###----
-#---#----##-
####-#-#-#-##
---#---#-#---
-#-####---##-
-#------#----
-###########-
------------@