--##---##----
-#---#----##-
-###-#-#-#-##
-------#-#---
-#####----##-
-#------#--@-
-###########
-------##----