############
#----------#
########--##
#------#--##
#-####-#--##
#----#-#--##
####-#-#--##
#----#-#--##
#-####-#--@#
#----------#
############